111111111111
10000000C001
100E00000001
10000000P001
111111111111