111111111111
1000100CP001
100E00000001
10C000011001
111111111111