111111111111
100000000001
10000000P001
111111111111