11111111111111111111111
10101C10000000000000001
11101011000000000000001
1P000000000000000000001
100000000000E0000001111
100C0000000000000000C01
11111111111111111111111