11111111111111111111111
1E001C10000000000000001
10001011000000000000001
1P000000000000000000001
10000000000000000001111
100C0000000000000000C01
11111111111111111111111