11111111111111
1E000000C00C11
111000C0000011
11111001111111
1111100P000111
10000000M00001
11111111111111