11111111111111
1C0M0000C00C11
110000E0000011
11111001111111
1111100000M111
1PC00C1M0000C1
11111111111111